WWWWWWWWW
PPPPPPPPW
PPPPPPPPP
PPPPPPPPP
PPPPPPPPP
PPPPPPPPP
PPPPPPPPP
PPPPPPPPP