FFFFFF.....FFFF
FFFF.......FFAF
FFM..E.....MFFF
FA............F
.......A.......
.........M...A.
.........E....F
.A....FF.....FF
.......F....FFF