RRRPPPPPPPPRRR
RRRPPPPPPPPRRR
PPPPPPPPPPPPPP
PPPPPPPPPPPPPP
WWWWWWWWWWWWWW
WWWWWWWWWWWWWW
PPPPPPPPPPPPPP
PPPPPPPPPPPPPP
RRRPPPPPPPPRRR
RRRPPPPPPPPRRR