...EAFF..
....EFF..
FFF..FF..
FFFM.F..E
AE..A..EA
E..F.MFFF
..FF..FFF
..FFE....
..FFAE...