.....AM....F
F...........
F...EFFE....
.....B.....F
.FM..B..M.FF
.....B......
.....A....FF
.........FFF