PPPWWPPPP
PPPPWPPPP
PPPPWWWPP
PPPPWPWPP
PWWWWWWWW
PWPPPPPWW
WWPPPPPPP