PPPPPPPWWWPPP
PPPPPPPWPPPPP
PPPPPWWWPPPPP
PPPPWWPWWPPPP
PPPPWPPPWPPPP
PPPPWWPWWPPPP
PPPPWWWWPPPPP
PPPPWPPPPPPPP
PPWWWPPPPPPPP