PPPPPPPPPPPPPPPP
PPPPPPPPPPPPPPPP
PPPPWWWWWWWPPPPP
PPPPWPPPPPWWWWWW
WWWWWPPPPPWWWWWW
PPPPWPPPPPWWWWWW
PPPPWWWWWWWPPPPP
PPPPPPPPPPPPPPPP
PPPPPPPPPPPPPPPP