FF.......FFFF...
F.M.EB..F....A..
.....B........B.
.....BFF.E....B.
.......A.BBBBBB.
.....BF.F.....B.
FFFA.B........B.
.....BFFF....M..
...FFFF........F