PPWPPPPPPPPP
PPWPPPPPPPPP
PPWWWPPPPPPP
PPPPWWWWPPPP
PPPPPPPWWWWP
PPPPPPPPPPWW