...A..FF..A...
.......F......
.............A
MBA.FEBFM..EB.
.B....BB....B.
.B....BB....B.
.BE..MFBEF.ABM
A.............
......F.......
...A..FF..A...