PPPPPPPPPPPP
PPPPPPPPPPPP
PPPPPPPPPPPP
WWWWWWPPPPPP
PPPPPWWWPPPP
PPPPPPPWWWPP
PPPPPPPPPWWP
PPPPPPPPPPWP
PPPPPPPPPPWP