PPPPPPPPPPPP
PPPPPPPPPPPP
PPPPPPPWWWWW
PPPPPPWWPPPP
PPPPPWWPPPPP
PPPPWWPPPPPP
PPPPWPPPPPPP
PPPPWPPPPPPP