PPPPPPPPPWD
PPPPPPPPWWD
PPPPPPWWWDD
PPPPWWWDDDD
PPPPWWDDDDD
PPPPPWWDDDD
PPPPPPWWWDD
PPPPPPPPWWD
PPPPPPPPPWD
PPPPPPPPPWD