PPPPPPPPWPPP
PPPPPPPPWPPP
PPPPPPPPWPPP
PPPPPPPWWPPP
WWWWWWWWPPPP
WWWWWWWPPPPP
PPPPPPPPPPPP
PPPPPPPPPPPP