FFFF...FFFF
FFF..E.MFFF
FF.......FF
F.........F
....A.A....
....A.A....
...........
FFM.BBB...F
FFF.....FFF
FFFF...FFFF