FF.....FF.E..
F.RRRRRRRRRR.
..R...M..FAR.
..RA.......R.
.MR....F.EMR.
..R........R.
..RRRR.A..FR.
...E.......R.
.F...F..FF.R.
FEF...A....RM
F.F...RRRRRR.
FF....R......
E.....R...F.F