RRRRRRPPPPPPPPPPR
PRRRRPPPPPPPPPPPP
PPRRPPPPPPPPPPPPP
PPPRPPPPPPPPPPPPP
PPPPPPPPPPPPPPPPP
PPPRPPPPPPPPPPPPP
PPRRRPPPPPPPPPPPP
PPRRRRPPPPPPPPPPR
PRRRRRRPPPPPPPPRR