PPPPPPPPPPPPPPPPPPPPPPPPPPPPPPPPPPWWWWWPPPPP
PPPPPPPPPPPPPPPPPPPPPPPPPPPPPPPPPWWDWWWWPPPP
PPPPPPPPPPPPPPPPPPPPPPPPPPPPPPPPPWWDDWWWWWPP
PPPPPPPPPPPPPPPPPPPPPPPPPPPPPPPPPWWDDDDWWWWP
PPPPPPPPPPPPPPPPPPPPPPPPPPPPPPPPWWDDDDDDWWWW
PPPPPPPPPPPPPPPPPPPPPPPPPPPPPPPPWWWDDDDDDWWW
PPPPPPPPPPPPPPPPPPPPPPPPPPPPPPPPWWWDDDDDWWWD
PPPPPPPPPPPPPPPPPPPPPPPPPPPPPPPPPWWWDDDWWWWD
PPPPPPPPPPPPPPPPPPPPPPPPPPPPPPPPPWWWDDWWWDDD
PPPPPPPPWWPPPPPPPPPPPPPPPPPPPPPPPPWWWWWWDDDD
PPPPPPPPWWPPPPPPPPPPPPPPPPPPPPPPPPPWWWWWPPPP
PPPPPPPPPPPPPPPPPPPPPPPPPPPPPPPPPPPPWWWPPPPP