PPPPPPPPPPPPPPPPP
PPPPPPPPPPPPPPPPP
PPPPPPPPPPPPPPPPP
PPPPPPPPPPPPPPPWW
PPPPPPPPPPPPPPPWW
PPPPPPPPPPPPPPPPW
PPPPPPPPPPPPPPPPP
PPPPPPPPPPPPPPPPP
PPPPPPPPPPPPPPPPW
PPPPPPPPPPPPPPPWW
PPPPPPPPPPPPPPPWW
PPPPPPPPPPPPPPWWW