FFF..........FFFF
........A.......F
...F....R..F..M..
...FF...R........
.....E.RRRRRAF...
..M....RFFF......
F......RFF....M..
FF..ARRRR...FF...
.....E..R....E...
..M.....R........
F...F...A..E.F...
F....FF...FF.....