...FF..........
.A.F....BBBBBA.
F..M........EBM
F..FF........B.
F.......F.M..B.
.............B.
...F...A.....B.
.B.............
.B...FF........
.B........F..F.
EB..M....F..FFF
.A...........A.
........FF.M...