FFF......FFF
FF........FF
............
............
...BBB......
..........IF
...........F