PPPPPPPPPPP
PPPPPPPPPPP
PPPPPRPPWPP
PWPPPRPPPPP
PPPPPRPPWWP
PPWWPRPPWWP
PPWWPRPPPPP
PPPPPRPPPPP
PPPPPRPPPPP
PPPPPPPPPPP