..FFFFFFFFFFF..
.FFFM.....MFFF.
FFFF.......FFFF
FFFFFFFFFFFFFFF
...............
..A.E.....E.A..
.......A.......
FFFFFFFRFFFFFFF
FFFFFFFRFFFFFFF
.FFFMRRRRRMFFF.
..FF.......FF..