F.FE......F.
FFF..A.E....
.F..........
.FFE..E.....
............
......RRRRR.
F....RRF....
.F...R....FF