PPPPPPPPWWDWPPP
PPPPPPPPPWDWPPP
PPPPPPPPPWWWPPP
PPPPPPPPPPPWWWW
PPPPPPPPPPPPWDD
PPPPPPPPPPPPWWW
PPPPPPPPPPPPPPW
WPPPPPPPPPPPPPP
WWWPPPPPPPPPPPP
WWWWPPPPPPPPPPP
PPPWPPPPPPPPPPP
PPPWWWPPPPPPPPP
PPPWDWPPPPPPPPP