PPPPPPPPPPPPPP
PPPPPPPPPPPPPP
PPPPPPPPPPPTPP
PTPPPPPPPPPTPP
PTPPPPPTTTTTPP
PTPPPPPTPPPPPP
PTPPPPPTPPPPPP
PTPPPPPTPPPPPP
PTTTTTTTTTTPPW
WWPPPPPPPTPWWW
WWWWWWWWWWWWDD