..............
RRRRRA...M....
....RR...H....
...AHRRRRRR..R
..............
..............
.........H.M..
....EM........
..............
..........A...
..............