..FF.....
.....EF..
...F.F...
..FE.....
....FF...