PPPPPPPPWP
PPPPPPPPWP
PPPPPPPWWP
WWWWWWWWPP
PPPPPPPPPP
PPPPPPPPPP