FFF....F.F
F..F......
..........
..........
......E..F
F.E....FFF