PPWWPPPPWWPP
PPWWPPPPWWPP
PPWWPPPPWWPP
PPPWWPPWWPPP
PPPPWWWWPPPP
PPPPPPPPPPPP
PPPPPPPPPPPP
PPPPPPPPPPPP