..F..EF...A..
.F...MBBB..F.
...FF...FE...
.E....BBBBF..
A.....A.....A
..FBBBB....E.
...E....F....
F.A...E...F..
.F...F.M.F...