.........
....FFF..
I...FFFFF
F...FFFFF
F.RRFFFF.
F.FRFFFF.
FA.RRRFFR
F..R..RR.