FFM.BBB.E..
FA.......A.
...........
...BBBBB..M
...........
.A......A..
...A.....EF
..M......FF