FFFM.FF...FFF..
F.HFF.FH...FMFF
F.FA.......AFHF
FF.FFF.HFFF...F
....E.....E....
.F.......F...F.
..F.F.....F....
...............
.FMF.......FMF.
..FF...A...FF..
...............