PPPPPWPPP
PPPPPWPPP
PPPPWWPPP
PPWWWPPPP
PPWPPPPPP